.,-_ '`!?:;­´"()[]<>{}/\*«»‘’‚‛“”„‟…=
aÀÁÂÃÄÅÆĀĂǠǢǍǞǺǼȀȂȦàáâãäåæāăǡǣǎǟǻǽȁȃȧ=A
bƀƁƂƃƄƅ=B
cÇĈĊČƆƇçĉċčƈ=C
dĎĐƉƊƋďđƌƍ=D
eÈÉÊËĒĔĖĚƎƏƐȄȆȨèéêëēĕėěȅȇȩ=E
fƑƒ=F
gĜĞĠĢƓǤǦǴĝğġģǥǧǵ=G
hĤĦǶȞĥħƕǷȟ=H
iÌÍÎÏĨĪĬĮİĲƖȈȊìíîïĩīĭįıĳƗȉȋ=I
jĴĵ=J
kĶƘǨķĸƙǩ=K
lĹĻĽĿĺļľŀƛƚ=L
mƜµ=M
nÑŅŇŊƝñņňŉŋƞ=N
oÒÔÕÖØŌŎŐŒƟƠƢǑǪǬǾȌȎȪȬȮȰòôõöøōŏőœơƣǒǫǭǿȍȏȫȭȯȱ=O
pƤƥ=P
q=Q
rŔŖŘƦȐȒŕŗřȑȓ=R
sßŜŞŠƧƩȘŝşšƨƪș=S
tŢŤŦƬƮȚţťŧƫƭț=T
uÙÚÛÜŨŪŬŮŰŲƯƱǓǕǗǙǛȔȖùúûüũūŭůűųưƲǔǖǘǚǜȕȗ=U
v=V
wŴŵ=W
x=X
yÝŶŸƳȲýÿŷƴȳ=Y
zŽƵƷƹƻǮȤžƶƸƺǯȥZ=Z
ąĄ=Ą
ęĘ=Ę
ćĆ=Ć
łŁ=Ł
ńŃ=Ń
óÓ=Ó
śŚ=Ś
źŹ=Ź
żŻ=Ż